111,111,111,111,111,111,111,111,111,111,45,111,111,111,111,111,111,111,111,111,111,111,111,111,45,79,79,79,111,79,79,111,111,111,111,111,111,111,79,79,79,111,79,111,111,111,111,111,111,79,79,111,111,111,111,111,111,111,111,111,111,111,79,111,45,79,111,111,111,45,111,79,79,111,79,45,79,111,111,79,79,79,111,111,111,79,79,111,79,111,79,111,79,79,79,79,79,79,111,111,111,111,111,111,111,111,111,111,111,111,111,111,111,111,111,111,111,111,111,111,111,111,111,111,111,111,111,111,111,111,111,111,111,111,111,111,111,111,111,111,111,111,111,111,111,111,111,111,111,111,111,111,111,111,111
111,111,111,111,111,111,111,111,111,111,45,111,111,111,111,111,111,111,111,111,111,111,111,111,45,111,111,111,79,79,111,111,79,79,79,111,79,111,111,111,79,79,111,111,111,111,79,111,79,111,111,79,111,79,79,111,111,111,111,111,111,111,79,79,45,79,111,79,79,45,79,111,111,111,111,45,111,79,111,79,79,111,79,111,45,79,79,79,111,79,111,79,111,111,79,79,111,111,45,111,111,111,111,111,111,111,111,111,111,111,111,111,111,111,111,111,111,111,111,111,111,111,111,111,111,111,111,111,111,111,111,111,111,111,111,111,111,111,111,111,111,111,111,111,111,111,111,111,111,111,111,111,111,111,111
111,111,111,111,111,111,111,111,111,111,45,111,111,111,111,111,111,111,111,111,111,111,111,111,45,111,79,111,111,79,111,79,79,111,79,111,111,79,79,111,79,79,79,111,111,111,79,79,111,111,79,79,79,79,79,111,79,111,111,111,79,111,79,79,45,111,111,79,111,45,111,111,79,111,111,45,79,79,79,79,79,79,79,79,45,111,79,111,111,111,79,111,111,79,79,111,111,79,45,111,111,111,111,111,111,111,111,111,111,111,111,111,111,111,111,111,111,111,111,111,111,111,111,111,111,111,111,111,111,111,111,111,111,111,111,111,111,111,111,111,111,111,111,111,111,111,111,111,111,111,111,111,111,111,111
111,111,111,111,111,111,111,111,111,111,45,111,111,111,111,111,111,111,111,111,111,111,111,111,45,111,111,79,79,79,111,111,79,79,111,79,111,79,111,111,111,79,79,79,79,79,111,111,111,111,79,111,79,79,111,111,111,111,111,79,111,79,79,111,45,111,79,111,79,45,79,111,79,111,111,45,79,111,111,111,79,79,79,111,45,111,79,79,79,79,79,111,79,111,79,79,79,79,45,111,111,111,111,111,111,111,111,111,111,111,111,111,111,111,111,111,111,111,111,111,111,111,111,111,111,111,111,111,111,111,111,111,111,111,111,111,111,111,111,111,111,111,111,111,111,111,111,111,111,111,111,111,111,111,111
111,111,111,111,111,111,111,111,111,111,45,111,111,111,111,111,111,111,111,111,111,111,111,111,45,79,111,111,79,79,111,79,79,79,79,111,79,111,79,111,111,79,79,111,111,111,111,111,79,79,111,111,111,111,79,79,111,79,79,79,79,111,79,79,45,111,111,79,79,45,79,111,79,79,79,45,111,79,111,111,111,79,111,111,45,79,111,79,79,79,111,111,79,79,79,79,111,111,45,111,111,111,111,111,111,111,111,111,111,111,111,111,111,111,111,111,111,111,111,111,111,111,111,111,111,111,111,111,111,111,111,111,111,111,111,111,111,111,111,111,111,111,111,111,111,111,111,111,111,111,111,111,111,111,111
111,111,111,111,111,111,111,111,111,111,45,111,111,111,111,111,111,111,111,111,111,111,111,111,45,111,111,79,111,79,111,111,111,79,111,111,111,79,111,111,79,79,111,111,79,79,79,111,111,79,111,79,111,79,111,79,79,111,79,79,111,111,79,111,45,79,111,111,79,45,79,79,79,79,111,45,111,111,111,111,79,111,111,79,45,111,79,111,79,79,79,111,79,111,79,111,111,111,45,111,111,111,111,111,111,111,111,111,111,111,111,111,111,111,111,111,111,111,111,111,111,111,111,111,111,111,111,111,111,111,111,111,111,111,111,111,111,111,111,111,111,111,111,111,111,111,111,111,111,111,111,111,111,111,111
111,111,111,111,111,111,111,111,111,111,45,111,111,111,111,111,111,111,111,111,111,111,111,111,45,111,111,79,111,111,111,111,111,79,79,79,79,79,111,79,111,79,79,79,79,111,79,111,111,79,79,111,111,79,79,111,79,111,79,111,79,111,111,111,45,79,111,111,79,45,79,111,79,111,111,45,79,79,79,111,79,111,111,111,45,79,111,79,111,111,79,111,111,111,111,79,79,79,45,111,111,111,111,111,111,111,111,111,111,111,111,111,111,111,111,111,111,111,111,111,111,111,111,111,111,111,111,111,111,111,111,111,111,111,111,111,111,111,111,111,111,111,111,111,111,111,111,111,111,111,111,111,111,111,111
111,111,111,111,111,111,111,111,111,111,45,111,111,111,111,111,111,111,111,111,111,111,111,111,45,111,79,79,79,111,79,111,79,111,79,79,79,111,111,79,79,79,79,111,111,79,111,79,79,111,79,79,111,79,111,111,79,111,79,79,79,111,111,111,45,111,111,111,111,45,111,79,111,79,111,45,111,111,79,79,111,111,111,111,45,111,111,79,111,79,79,79,79,111,79,79,79,79,45,111,111,111,111,111,111,111,111,111,111,111,111,111,111,111,111,111,111,111,111,111,111,111,111,111,111,111,111,111,111,111,111,111,111,111,111,111,111,111,111,111,111,111,111,111,111,111,111,111,111,111,111,111,111,111,111
111,111,111,111,111,111,111,111,111,111,45,111,111,111,111,111,111,111,111,111,111,111,111,111,45,111,111,79,111,111,111,79,111,79,111,79,79,79,111,79,111,79,111,111,111,111,79,111,79,79,111,111,79,79,111,79,79,79,111,111,79,79,79,111,45,79,111,79,111,45,111,111,111,111,79,45,79,79,111,111,111,79,79,111,45,79,111,111,79,79,111,111,79,111,79,79,111,79,45,111,111,111,111,111,111,111,111,111,111,111,111,111,111,111,111,111,111,111,111,111,111,111,111,111,111,111,111,111,111,111,111,111,111,111,111,111,111,111,111,111,111,111,111,111,111,111,111,111,111,111,111,111,111,111,111
111,111,111,111,111,111,111,111,111,111,45,111,111,111,111,111,111,111,111,111,111,111,111,111,45,111,111,79,79,111,111,79,79,111,79,111,111,79,111,111,111,111,79,79,79,111,79,111,111,79,111,79,79,111,111,111,111,79,111,111,79,111,111,111,45,79,79,79,79,45,111,79,111,111,111,45,79,79,111,111,79,79,111,111,45,79,111,79,79,79,111,79,111,111,111,79,111,111,45,111,111,111,111,111,111,111,111,111,111,111,111,111,111,111,111,111,111,111,111,111,111,111,111,111,111,111,111,111,111,111,111,111,111,111,111,111,111,111,111,111,111,111,111,111,111,111,111,111,111,111,111,111,111,111,111
111,111,111,111,111,111,111,111,111,111,45,111,111,111,111,111,111,111,111,111,111,111,111,111,45,111,79,79,111,79,111,111,111,111,79,111,79,79,79,79,111,79,79,79,79,111,111,111,111,111,79,111,111,79,79,79,79,111,111,79,79,111,79,111,45,79,111,111,79,45,79,111,79,79,111,45,111,79,111,111,79,79,79,111,45,111,111,79,79,79,111,111,111,79,111,111,111,79,45,111,111,111,111,111,111,111,111,111,111,111,111,111,111,111,111,111,111,111,111,111,111,111,111,111,111,111,111,111,111,111,111,111,111,111,111,111,111,111,111,111,111,111,111,111,111,111,111,111,111,111,111,111,111,111,111
111,111,111,111,111,111,111,111,111,111,45,111,111,111,111,111,111,111,111,111,111,111,111,111,45,111,79,79,111,111,79,79,79,111,111,79,79,111,111,79,111,79,79,111,79,79,111,79,79,79,111,79,79,79,111,111,111,79,111,79,111,111,79,111,45,111,111,111,79,45,79,111,111,79,111,45,111,111,111,79,79,79,79,79,45,79,79,79,79,111,111,111,111,111,111,111,79,79,45,111,111,111,111,111,111,111,111,111,111,111,111,111,111,111,111,111,111,111,111,111,111,111,111,111,111,111,111,111,111,111,111,111,111,111,111,111,111,111,111,111,111,111,111,111,111,111,111,111,111,111,111,111,111,111,111
111,111,111,111,111,111,111,111,111,111,45,111,111,111,111,111,111,111,111,111,111,111,111,111,45,79,79,111,79,79,79,79,79,111,79,79,79,111,79,111,111,111,79,111,111,79,111,79,79,111,79,79,111,111,79,111,111,79,79,111,111,111,111,111,45,111,79,111,79,45,79,111,111,111,79,45,111,79,111,111,79,111,111,79,45,111,111,111,111,111,79,111,79,111,111,111,111,111,45,111,111,111,111,111,111,111,111,111,111,111,111,111,111,111,111,111,111,111,111,111,111,111,111,111,111,111,111,111,111,111,111,111,111,111,111,111,111,111,111,111,111,111,111,111,111,111,111,111,111,111,111,111,111,111,111
111,111,111,111,111,111,111,111,111,111,45,111,111,111,111,111,111,111,111,111,111,111,111,111,45,111,111,79,79,79,111,79,111,111,79,79,79,111,111,111,79,111,111,111,79,111,111,111,79,111,111,111,79,111,79,79,79,111,79,79,79,111,111,111,45,79,79,111,79,45,111,79,111,111,111,45,79,79,79,111,79,79,79,79,45,79,111,111,111,111,79,111,111,111,111,79,111,111,45,111,111,111,111,111,111,111,111,111,111,111,111,111,111,111,111,111,111,111,111,111,111,111,111,111,111,111,111,111,111,111,111,111,111,111,111,111,111,111,111,111,111,111,111,111,111,111,111,111,111,111,111,111,111,111,111
111,111,111,111,111,111,111,111,111,111,45,111,111,111,111,111,111,111,111,111,111,111,111,111,45,79,79,111,111,111,111,79,79,79,79,79,111,111,111,111,111,111,111,79,79,79,79,79,79,79,111,111,111,79,111,79,79,79,79,111,111,111,79,111,45,111,79,111,79,45,79,111,111,111,111,45,79,111,79,111,111,79,111,79,45,111,79,111,111,111,79,111,111,111,111,79,79,79,45,47,47,47,111,111,47,47,47,47,47,111,111,47,47,47,111,111,111,111,111,111,111,111,111,111,111,111,111,111,111,111,111,111,111,111,111,111,111,111,111,111,111,111,111,111,111,111,111,111,111,111,111,111,111,111,111
111,111,111,111,111,111,111,111,111,111,45,111,111,111,111,111,111,111,111,111,111,111,111,111,45,79,79,111,111,111,79,111,111,111,111,111,111,79,111,79,111,111,111,111,111,111,79,111,111,79,79,111,111,79,111,111,111,111,111,79,111,79,111,111,45,79,111,111,79,45,79,111,79,79,111,45,79,111,111,111,79,111,79,111,45,79,79,79,79,79,79,79,111,111,79,111,111,111,45,47,111,111,47,47,111,111,111,111,111,47,47,111,111,47,111,111,111,111,111,111,111,111,111,111,111,111,111,111,111,111,111,111,111,111,111,111,111,111,111,111,111,111,111,111,111,111,111,111,111,111,111,111,111,111,111
111,111,111,111,111,111,111,111,111,111,45,111,111,111,111,111,111,111,111,111,111,111,111,111,45,111,111,111,111,111,79,111,79,111,111,111,111,79,111,111,111,111,79,111,111,111,79,79,111,111,111,111,79,111,111,111,111,111,111,111,79,111,79,79,45,79,116,117,118,45,79,111,111,79,111,45,111,111,111,111,111,79,79,111,45,79,79,111,79,111,79,111,111,111,79,79,79,79,45,111,47,111,47,47,111,111,111,111,111,47,47,111,47,111,111,111,111,111,111,111,111,111,111,111,111,111,111,111,111,111,111,111,111,111,111,111,111,111,111,111,111,111,111,111,111,111,111,111,111,111,111,111,111,111,111
111,111,111,111,111,111,111,111,111,111,45,111,111,111,111,111,111,111,111,111,111,111,111,111,45,111,79,111,111,79,111,111,111,79,111,111,111,79,111,111,111,111,79,79,79,79,111,79,111,111,111,111,111,111,79,111,79,79,111,111,79,111,111,79,45,111,119,120,121,45,79,111,79,79,111,45,79,111,79,111,111,79,79,111,45,79,79,79,111,79,111,79,111,111,79,79,111,111,45,111,111,47,111,111,47,111,111,111,47,111,111,47,111,111,111,111,111,111,111,111,111,111,111,111,111,111,111,111,111,111,111,111,111,111,111,111,111,111,111,111,111,111,111,111,111,111,111,111,111,111,111,111,111,111,111
111,111,111,111,111,111,111,111,111,111,45,111,111,111,111,111,111,111,111,111,111,111,111,111,45,79,111,79,111,79,111,79,79,79,79,79,79,79,79,111,111,79,111,111,111,79,111,111,79,79,111,79,111,111,79,79,111,111,111,79,79,79,79,111,45,111,122,123,124,45,111,79,111,111,111,45,116,117,118,79,111,111,79,111,45,111,79,111,111,111,79,111,111,79,79,111,111,79,45,111,47,111,47,111,111,47,111,47,111,111,47,111,47,111,111,111,111,111,111,111,184,189,182,184,176,184,185,184,185,183,178,187,111,111,111,111,111,111,111,111,111,111,111,111,111,111,111,111,111,111,111,111,111,111,111
111,111,111,111,111,111,111,111,111,111,45,111,111,111,111,111,111,111,111,111,111,111,111,111,45,79,79,79,111,79,111,111,111,111,111,79,111,79,79,111,79,111,79,111,79,111,111,79,79,111,79,111,111,111,111,111,111,111,111,79,79,111,111,79,45,111,79,79,111,45,111,116,117,118,111,45,119,120,121,111,111,79,79,79,45,111,79,79,79,79,79,111,79,111,79,79,79,79,45,111,47,111,111,47,184,180,111,184,180,47,111,111,47,111,111,111,111,111,111,111,182,182,182,184,111,186,189,186,189,111,183,111,111,111,111,111,111,111,111,111,111,111,111,111,111,111,111,111,111,111,111,111,111,111,111
111,111,111,111,111,111,111,111,111,111,40,46,46,46,46,46,46,46,46,46,46,46,46,46,39,79,79,79,111,111,111,79,111,111,79,79,111,79,79,111,111,111,111,111,111,111,111,111,79,79,79,111,79,111,79,111,79,111,111,111,79,111,79,79,45,79,79,111,111,50,79,119,120,121,79,45,122,123,124,111,111,79,111,111,45,79,111,79,79,79,111,111,79,79,79,79,111,111,45,111,47,111,111,111,182,185,111,182,185,111,111,111,47,111,111,111,111,111,111,111,182,111,182,186,178,182,188,182,188,111,182,111,111,111,111,111,111,111,111,111,111,111,111,111,111,111,111,111,111,111,111,111,111,111,111
111,111,111,111,111,111,111,111,111,111,27,30,27,30,27,30,27,30,27,30,27,30,27,30,27,111,111,111,111,111,111,111,111,79,111,111,79,111,111,111,111,79,111,111,111,111,111,111,111,111,111,111,111,111,111,79,79,79,111,111,111,79,111,111,50,79,79,111,111,27,111,122,123,124,79,45,111,111,79,79,79,111,111,79,40,46,46,46,46,46,46,46,46,46,46,46,46,46,39,111,47,111,111,47,180,180,111,180,180,47,111,111,47,111,111,111,111,111,111,111,183,111,182,184,189,182,189,180,178,189,180,111,111,111,111,111,111,111,111,111,111,111,111,111,111,111,111,111,111,111,111,111,111,111,111
111,111,111,111,111,111,111,111,111,111,111,111,111,111,111,111,111,111,111,111,111,111,111,111,111,111,111,111,79,111,79,111,125,79,111,79,111,111,79,111,125,111,111,79,111,111,125,111,111,79,79,111,111,111,111,111,111,111,111,111,111,79,79,111,27,111,111,111,111,79,79,111,79,111,79,50,79,111,79,111,111,111,79,111,27,30,27,30,27,30,27,30,27,30,27,30,27,30,27,111,47,111,47,111,47,111,47,47,47,111,47,111,47,111,111,111,111,111,111,111,111,184,111,182,182,182,186,181,182,186,178,111,111,111,111,111,111,111,111,111,111,111,111,111,111,111,111,111,111,111,111,111,111,111,111
111,111,111,111,111,111,111,111,111,111,17,18,17,18,17,18,17,18,17,18,17,18,17,18,17,79,111,111,79,111,111,79,111,111,79,111,125,111,111,111,111,111,111,79,111,111,111,111,111,111,111,111,111,111,79,111,111,79,111,111,111,111,111,111,111,111,79,79,111,17,111,111,79,111,111,27,111,79,111,79,111,111,111,111,111,111,111,111,111,111,111,111,111,111,111,111,111,111,111,111,111,47,111,47,111,47,111,47,111,47,111,47,111,111,111,111,111,111,111,111,183,111,182,182,111,182,182,111,182,181,187,111,111,111,111,111,111,111,111,111,111,111,111,111,111,111,111,111,111,111,111,111,111,111,111
111,111,111,111,111,111,111,111,111,111,37,46,46,46,46,46,46,46,46,46,46,46,46,46,38,111,79,111,111,111,190,79,79,79,191,111,79,111,190,79,111,111,191,79,190,111,79,111,191,111,111,111,79,79,79,111,111,111,111,111,111,111,111,111,17,111,111,111,111,48,111,79,111,111,111,111,111,79,111,116,117,118,111,111,17,18,17,18,17,18,17,18,17,18,17,18,17,18,17,111,111,111,47,47,47,47,47,47,47,47,47,111,111,111,111,111,111,111,111,111,111,111,111,111,111,111,111,111,111,111,111,111,111,111,111,111,111,111,111,111,111,111,111,111,111,111,111,111,111,111,111,111,111,111,111
111,111,111,111,111,111,111,111,111,111,45,111,111,111,111,111,111,111,111,111,111,111,111,111,45,79,111,111,111,79,111,111,111,79,111,111,111,111,111,111,111,111,111,79,111,79,79,79,79,111,79,79,111,111,79,79,79,111,111,111,111,111,111,111,48,116,117,118,111,45,111,79,111,111,111,17,111,111,79,119,120,121,111,111,37,46,46,46,46,46,46,46,46,46,46,46,46,46,38,111,111,111,111,47,111,111,111,111,111,47,111,111,111,111,111,111,111,111,111,111,111,111,111,111,111,111,111,111,111,111,111,111,111,111,111,111,111,111,111,111,111,111,111,111,111,111,111,111,111,111,111,111,111,111,111
111,111,111,111,111,111,111,111,111,111,45,111,111,111,111,111,111,111,111,111,111,111,111,111,45,79,79,79,79,79,79,17,17,17,79,79,79,79,79,17,17,17,79,79,79,17,17,17,79,79,79,79,79,79,79,79,79,79,79,79,79,79,79,79,45,119,120,121,79,45,79,79,79,79,79,48,79,79,79,122,123,124,79,79,45,79,79,111,79,111,79,111,111,111,79,79,79,79,45,111,111,111,111,111,47,47,47,47,47,111,111,111,111,111,111,111,111,107,111,111,111,111,111,111,111,111,111,111,111,111,111,111,111,111,111,111,111,111,111,111,111,111,111,111,111,111,111,111,111,111,111,111,111,111,111
